1111111111111
10P0010000101
1101000101111
1111111101111
1111100000011
1001001000001
1111111111111