NO ./path_to_the_north_texture
SO ./path_to_the_south_texture
WE ./path_to_the_west_texture
EA ./path_to_the_east_texture

F 220,100,0
C 225,30,0

1111111111111
10P00100001011
1101000101111
11111111011011
1111100000011
1001001000001
1100000000001
11111111111111